type octile
height 6
width 5
map
@@@@@
@...@
@.T.@
@.T.@
@...@
@@@@@
