type octile
height 13
width 25
map
@@@@@@@@@@@@@@@@@@@@@@@@@
@@@@.@@@@@@@@@@@@@@@@@@@@
@@@@.@@@@@@@@@@@@@@@@@@@@
@@@..@@@@@@@@@@@@@@@@@@@@
@@@..@@@@@@@@@@@@@@@@@@@@
@@...@@@@@@@@@@@@@@@@@@@@
@.....@@@@@@@@@@@@@@@@@@@
@@...@@@@@@@@@@@@@@@@@@@@
@@@@@@@@@@@@@@@@@@@@@@@@@
@@@@@@@@@@@@@@@@@@@@@@@@@
@@@@@@@@@@@@@@@@@@@@@@@@@
@@@@@@@@@@@@@@@@@@@@@@@@@
@@@@@@@@@@@@@@@@@@@@@@@@@
@@@@@@@@@@@@@@@@@@@@@@@@@