type octile
height 8
width 14
map
@@@@@@@@@@@@@@
@.S........@@@
@.@@@@@@@@.@@@
@...@@@..G.@@@
@@@..@@.@@@@@@
@@@.@@@.@@@@@@
@@@.....@@@@@@
@@@@@@@@@@@@@@
